/p
==============
=  2         =
=  -         =
=*   *       =
=-   #*K  K *b=
=    ---  - -=
=      *     =
=1*_ -==- *  r=
==============
/p
==============
=      2     =
=      =     =
=            =
=            =
=            =
=            =
=1           =
==============
