/p
==============
=  2         =
=  =         =
=            =
=  =         B
=      =  =  =
=   =        =
=1           R
==============
/p
==============
=      2     =
=      =     =
=            =
=            =
=            =
=            =
=1           =
==============
